oligo	WNT4	off_target
AAAACACGGAAGGTA	False	CDCA8,IL20RA
AACCGGCGCTGGAAC	True	
AACTCTGCCAAGGCC	False	ABCF2-H2BK1,KLHL33
AAGGAACCCATGAAT	False	ZC3H7A,ZNF189
AAGGAGCTGCAGCAG	False	KRT5,NPIPB4,NPIPB5
AAGGTGGTGACGAAA	True	
AAGTGCGGCTGTGAC	True	
AATTCACACTGGTGA	False	ZNF189,ZNF879
ACATCGTGGAGAACC	False	ASS1,FEM1A
ACCAGAGAGGCTATG	True	
ACTGGTGCCACGCAT	True	
AGAAACTCAAGGGCC	True	
AGAAGTAGAAGAAAA	False	CDCA8,DSC1
AGACGTGCGAGAAAC	True	
AGAGAATTCATACTG	False	ZNF189,ZNF879
AGAGCCTCAAGGACA	False	KCNQ2,PGAM2
AGCAGCTCAGGAGGC	False	MRPL12,SYNCRIP
AGCCACGCCGCGTGC	True	
AGCCTAGCCCCGACT	True	
AGCTGGCTGAACGCT	True	
AGCTGGTGCCTGAGC	False	PPP1R13L,SEPTIN3
AGGACCCTACCAAAC	True	
AGGGGCCGAACATGC	True	
AGTGGAAGAGGAAGA	False	CDCA8,KLHL33,USP36
ATAAATGTAGTGACT	False	ZNF189,ZNF879
ATATATGAAGTGAAT	False	RP1,ZNF879
ATATGCACTGCAGTG	False	BCL6,GPR15
ATCCACACTGGTGAA	False	BCL6,ZNF189
ATGCCACCCTCCAGT	False	DSC1,USP36
ATTCACACTGGTGAG	False	BCL6,ZNF189,ZNF879
ATTGTCCAGGCCTTC	False	MYADML2,USP36
CAACGCCATCGACGG	True	
CACAAGGCAAGAGGA	True	
CACCTCCCTGTCAGC	False	ATF6,BCL6
CAGCCCCCAGCCCCG	False	PPP1R13L,SSBP4
CAGGAACAGAGAATG	False	DTNA,ZNF189
CAGGAGGGACCCCGG	False	CYP27B1,PRRT1
CAGGGAAGGATGCCT	False	MTMR8,TRPM8
CAGGGCACTGGTGAC	True	
CAGTGACGCGGGCGT	True	
CATGAAAAAACTCAT	False	ZNF562,ZNF879
CATTCAACATCAAAG	False	ZNF189,ZNF879
CATTGAGGAGTGCCA	True	
CCAAAAGGAATGTCA	False	KPNA1,NRIP1
CCAACCACACCATCA	False	DTNA,SLC7A14
CCAACCTGAAAACCC	False	BCL6,TMPRSS2
CCAAGGCCATCTACG	True	
CCACGCAGGTGACAG	False	CCR2,SETDB1
CCAGTGTCTCTCCTA	False	SLC50A1,ZC3H7A
CCCTACAAATGTAAG	False	ZNF562,ZNF879
CCCTGGGCTCGGGCG	False	MAPK12,SSBP4
CCGAGGAGCTGGCTA	False	TMUB2,TRPM8
CCGCGGTGCCCAGCT	True	
CCTGAAGATCCTGCA	False	ADISSP,FEM1A
CCTGATGGTGCTAAC	False	ADAMTS3,ATF6
CCTTTGCCATGCTGG	False	CFAP91,MYADML2,SLC7A14
CGCTTCCACCCTGAG	False	NPIPB4,NPIPB5
CGGCAGGTGTGGCCT	True	
CGGGAGGCGGCCTTC	True	
CGTGCCGCCCTTCCG	True	
CGTGCTGGCGAGCCG	True	
CTCCGCTTCTCCGAT	False	BCL6,HMOX1
CTCTACGAGCGCCTG	False	ABCF2-H2BK1,ACTR10
CTGCTGTGGACTGCA	False	BCAP31,SLC7A3
CTGGAGAAAAACCCT	False	ZNF189,ZNF562,ZNF879
CTGGTGCTGCTTCGT	True	WNT5A
CTTCCACACTCAGCT	False	NPIPB4,NPIPB5
CTTCTGCTCCTTCAT	False	DPP9,SLC7A14
GAACCTCCACAACAA	True	BCAP31,WNT5A
GAACTCTTCTCCAAC	False	FEM1A,TRPM8
GAATGTGGAAAGGCC	False	ZNF189,ZNF879
GACAACATCGCCTAC	True	
GACAGGACTGTGCAT	True	
GACATGCGAAGCGGC	True	
GAGGAGCAGCGGCTA	False	DPP9,MRPL12
GAGTCGGCACTGGTT	False	RP1,SLC7A3
GATCAAGAGGCTGAG	False	KRT5,TRIM22
GATCCAGAGGCTGAG	False	KRT5,TRIM22
GATGGCACATTTGAC	False	RP1,ZNF879
GCAAGAGGAACAAGA	True	
GCAGCGCAAGAAGGT	False	ABCF2-H2BK1,CYP26A1
GCCACGCAACGCACA	True	
GCCGGTGGAATGCAA	True	
GCGAGAAACTCAAGG	True	
GCGCAGGTGGAGCGG	True	
GCGTGCTGGGCACGA	True	
GCTGAACGCTGCAGT	True	CD209
GCTGCAGGTGCAGGG	False	CYP27B1,KRT5
GCTGTACCGGGGCAT	False	CYP26A1,SLC25A41
GGAAGAAGAGGAAGA	False	CDCA8,KLHL33
GGAAGATCTGGAGGC	False	FEM1A,PGAM2
GGAGAGAAGCCCTAC	False	BCL6,ZNF875,ZNF879
GGAGCCACGCCGCGT	True	
GGAGGCCAAATCAAC	False	SEPTIN3,SETDB1
GGAGGCGGCCTTCGT	True	
GGCAATGGGATCATT	False	LAP3,USP36
GGCCATCGACGGCGG	True	
GGGCAGCTGAAGCTT	False	RP1,TRPM8
GGGCCCTCGTCCAGC	True	
GGGGAGAAACCTTAT	False	ZNF189,ZNF875,ZNF879
GGGGAGGAAGCCAAG	False	ADAMTS3,SLC7A14
GGGTGGAATGCAAGT	True	
GGTGGAGCGGGCTGA	True	
GGTGTCAGGCTCCTG	True	
GTACTTGGAGCCTAG	True	
GTCAGCCCACAGGGC	True	
GTGCGGGAGAGAAGC	True	
TAAGGAATGTAGGAA	False	ZNF562,ZNF879
TCACTGCCCTTCCAC	False	NPIPB4,NPIPB5
TCCACAACAATGAGG	True	
TCCACTGGTCAGGAT	True	
TCCCTTTCCACCCTC	False	NPIPB4,NPIPB5
TCCGCTTCTCCGATG	False	BCL6,HMOX1
TCTTCATCATCCTCC	False	CCR2
TCTTCCTATGGGAAA	False	ZNF189
TCTTCGGGGAAATAT	False	TRIM22
TCTTCTGAGGACTGG	False	NRIP1
TCTTGACCCTGGCTA	False	CFAP91
TCTTGCTTGCTCCAA	False	ACTR10
TCTTGTCACATTGCC	False	GPR15
TCTTTCACACGTCGT	False	UIMC1
TCTTTGCCACATCTG	False	KCNQ2
TCTTTTCATGGTCAG	False	ZC3H7A
TGAAAAATATGAAGT	False	EXOC1L
TGAAAATAAAATCTG	False	NRIP1
TGAAACCTATCTCAT	False	IL20RA
TGAAAGGAAAAGTTT	False	DSC1
TGAACAGGAGCTTTA	False	EVI2A
TGAACCTTTGCACCC	False	DTNA
TGAACTGACCAGGCA	False	KLF4,PPP1R13L
TGAAGAACCCAAAGG	False	UIMC1
TGAAGACGCTCAAGG	False	JUNB
TGAAGATAGCTGCCA	False	PLEKHM3
TGAAGCCACCACTGA	False	RP1
TGAAGCTTGGGGCCA	False	ASS1
TGAAGTAGATTATAA	False	EVI2A
TGAATACCCTGATGG	False	MTMR8
TGAATGATATTCTGA	False	BLMH
TGAATGTGGGAAGAC	False	ZNF189,ZNF562
TGACAAAAGATTCTT	False	IL20RA
TGACAGGGGGAACTG	False	NGDN
TGACATGGGAGGAGC	False	LAP3
TGACCAGCTCAAGAA	False	BCAP31
TGACCCAGGAACAGA	False	ZNF189
TGACCGCACACTGGA	False	MAPK12
TGACCTGCTACTGTT	False	GPR15
TGACTATCCATTAGA	False	ACTR10
TGACTGCGCCGAGTC	False	FEM1A
TGACTTCCTGTCCAA	False	CFAP91
TGAGAAATGGAACTA	False	TRPM8
TGAGAATCCGGCTGG	False	SLC7A14
TGAGAGAGTCAAAGA	False	TRIM22
TGAGATCTCTGAGAT	False	KRT5
TGAGCCAACTGATGC	False	ASS1
TGAGCGCACTATTCA	False	TRPM8
TGAGCTCTTGACCCT	False	CFAP91
TGAGGAACTGGGTAT	False	SETDB1
TGAGGAGGAATGTAG	False	ZC3H7A
TGAGGCCACTGGCAT	False	MTMR8
TGAGGGATTCTGCAT	False	BCL6
TGAGGTGGAGCTACA	False	HDDC3
TGAGTCATCTCTCTC	False	ZNF875
TGAGTGTAACAAACG	False	SETDB1
TGATAAAAAATCGAG	False	ATF6
TGATACTACTATACA	False	ARMT1
TGATATTCTGAATCA	False	BLMH
TGATCCCAAGGTTTT	False	TRIM22
TGATCTATGTGGAGG	False	MTMR8
TGATGAGGGCCCTGA	False	DSC1
TGATGCCTACAATGT	False	MYBPC1
TGATGGACTTGGCCC	False	RP1
TGATGGGGCTCACAA	False	GSTM5
TGATGTGATCGCTAG	False	TRPM8
TGATTCAATAGGTGC	False	ADAMTS3
TGATTGGGAACCACA	False	SLC7A3
TGCAAAAGCAAGGCA	False	ZC3H7A
TGCAAATGATGGTGG	False	BLMH
TGCAAGAAGAAGGTT	False	USP36
TGCAAGTGCCACGGG	True	WNT5A
TGCACAAGGAAGCCT	False	ZNF562
TGCACCCCAGAGGGA	False	HDDC3
TGCACGTGCCCCATG	False	SLC7A3
TGCAGAAAGCCTGCC	False	USP36
TGCAGAGAAAAAGGC	False	GPR15
TGCAGCACCTACCCT	False	MTMR8
TGCAGCCGCAAGTCC	False	KLF4
TGCAGGGAATGTGGG	False	ZNF875
TGCAGTCATCCATGT	False	NRIP1
TGCATACATATGAGA	False	ENPP2
TGCATCTCAGTTGCC	False	SYNCRIP
TGCATGGGCTCAGCC	True	
TGCATTGGGTGGGAG	False	KLHL33
TGCCAACCGCAGCCG	False	KRT5
TGCCACCAAGGTTTA	False	DPP9
TGCCACTTCTGGGAC	False	ARL4C
TGCCAGCTCCTGATG	False	MYOT
TGCCATCCGGAAGAG	False	CRHR1
TGCCCAAGGAGGTGG	False	TRPM8
TGCCCATCCCTGAGC	False	ABCF2-H2BK1
TGCCCCCGTTCCAGT	False	PLBD2
TGCCCGGTTACATGG	False	PLEKHM3
TGCCCTGCTTCGAGA	False	SEPTIN3
TGCCGCGGCTGCTGT	False	SCYGR6
TGCCTCATAGATACC	False	ANKRD33
TGCCTGAGAAATACT	False	SAA1
TGCCTGGTGAAGAAC	False	ATP1A2
TGCCTTTCTGCAGGA	False	OR13C9
TGCGAGAGCCTCAAG	False	PGAM2
TGCGCACTTGGCGCC	False	PGAM2
TGCGCTACACGCAGA	False	MAPK12
TGCGGATCTGGGCCG	False	KCNQ2
TGCGGCTGTGACAGG	True	
TGCGGGAGAGAACCA	True	
TGCGGTTCCTGGAGC	False	KRT5
TGCGTTCTCTGAACA	False	TMUB2
TGCTACATCATTGAT	False	SETDB1
TGCTCAGAGCTGACT	False	USP36
TGCTCCAGAGGAAAT	False	NGDN
TGCTCTGCAGCACGC	False	PTGES
TGCTGACAAGCTGTA	False	SETDB1
TGCTGATCGATGTGT	False	TRPM8
TGCTGCCACTGCCCC	False	CYSRT1
TGCTGCTCCAGCTGC	False	SCYGR6,SLC7A3
TGCTGGACATCTGTC	False	BLMH
TGCTGGCCAGGGGTA	False	FEM1A
TGCTGGTCATGGCTC	False	NRIP1
TGCTGTGCCCGGTTA	False	PLEKHM3
TGCTTACCATCCTGG	False	PLBD2
TGCTTCGTCAAGTGC	True	WNT5A
TGCTTGTCCCTATGT	False	EXOC1L
TGCTTTGTGGGGCTC	False	ATP1A2
TGGAAAAGAACCAGG	False	CFAP45
TGGAAAGAGGAAGAC	False	NPIPB4,NPIPB5
TGGAAATTCTCGTGT	False	CYP27B1
TGGAACCATCATTAC	False	NPIPB4,NPIPB5
TGGAAGCTGAATATT	False	SNX6
TGGAAGTTCGCGCCT	False	PLBD2
TGGAATTAATTCTGC	False	ACTR10
TGGACACATCCTGGC	False	ABCF2-H2BK1,NSDHL
TGGACCGGCGGGGAG	False	KCNQ2
TGGACGCGGAGCAGC	False	MAPK12
TGGACTCTGCCTCAT	False	ARMT1
TGGAGAAAGTGGAGT	False	FEM1A
TGGAGACAGATGTGC	False	MTMR8
TGGAGAGGGCCATCA	False	PTGES2
TGGAGCAGCTTAGCC	False	ANKRD33
TGGAGCTCTACGAGC	False	ABCF2-H2BK1
TGGAGGACTGCAATA	False	ZC3H7A
TGGAGGCCAGGATGG	False	PLEKHM3
TGGAGTATCATAACC	False	SNX6
TGGAGTTTACCAAGA	False	CFAP45
TGGATGAACTGAAAA	False	ASDURF
TGGATGCTGACCCTG	False	DNAJC22
TGGATGTTTTGAACA	False	ZNF189
TGGCAAAGAGCACGT	False	ADAMTS3
TGGCACACAGCCACA	False	USP36
TGGCAGAAACCTTTG	False	DNAJC22
TGGCAGTGGCTATGG	False	KRT5
TGGCCAAAGGATCTG	False	LAP3
TGGCCCGGCTGCTGC	False	KRT5
TGGCCGCCCCATAGC	False	DNAJC22
TGGCCTCATCACTGT	False	TMUB2
TGGCCTTAATTTTCA	False	GPR15
TGGCGCCGGGCGGCA	False	KLF4
TGGCGGTGGCCTCGG	False	KRT5
TGGCTATGCAACAAC	False	DSC1
TGGCTCGAGAAGCAG	False	CFAP45
TGGCTGCAATCCACC	False	SETDB1
TGGCTGGGAGTGTAC	False	ENPP2
TGGCTGTTGGCTCCC	False	SLC7A3
TGGCTTTGGCCATAT	False	WNT5A
TGGGAAATGTGACAG	False	CYP27B1
TGGGAATGCCATATG	False	DPP9
TGGGAGACAATGAGA	False	SLC7A14
TGGGAGGGGCTATTT	False	ACTR10
TGGGATTATAACATT	False	ADAMTS3
TGGGCCATCACAAAT	False	KPNA1
TGGGCCTGTGTCCAC	False	ANKRD33
TGGGCTCACTCTGCT	False	CCR2
TGGGCTGGGCTGGCT	False	DNAJC22
TGGGGACATGGGCAT	False	MTMR8
TGGGGCTCGGGGCGG	False	SSBP4
TGGGGGGCTACGTAG	False	PRRT1
TGGGGTTCAGAAACT	False	NSDHL
TGGGTGGTATACTGT	False	MYOT
TGGTAAAGGAGGACT	False	EXOC1L
TGGTAGGACTTGCAC	False	ADISSP
TGGTCAGACTCTCCC	False	PPP1R13L
TGGTCGCTAGGTATG	False	WNT5A
TGGTCTTGATGCTGA	False	MYBPC1
TGGTGCAGTGGGCTG	False	ATP1A2
TGGTGCTGCTGCCCC	False	CRHR1,CYSRT1
TGGTGGCACTGGATG	False	KLHL33
TGGTGGGCTGTGGCT	False	TRPM8
TGGTTACCAAAGTGT	False	SLC7A3
TGGTTGAGCTGCAAT	False	SETDB1
TGGTTTGGATGCAGC	False	SETDB1
TGTAACAACTCCTGG	False	TRIM43
TGTACCCAGCTCTGA	False	NSDHL
TGTACGGTCAAGTGT	False	WNT8A
TGTAGCAAAGTGCTC	False	ZC3H7A
TGTATACGACTGCGG	False	BLMH
TGTATGGGGTACTCA	False	MTMR8
TGTCAACGTCATCTT	False	ENPP2
TGTCACCTGCTCCCC	False	USP36
TGTCAGCAGCCTCCT	False	BCL6
TGTCATCCCTCACGA	False	ENPP2
TGTCCACACCGCCAG	False	BCL6
TGTCCCCAACAGCAA	False	JUNB
TGTCCTTCTCACTTC	False	ACTR10
TGTCTCCTTCTTCGC	False	KCNQ2
TGTCTGCCTGGAGTG	False	ZNF875
TGTCTTCCAACCCTG	False	ADAMTS3
TGTGAAGAATGTGGA	False	ZNF189,ZNF562
TGTGACTACCAGCTT	False	PLEKHM3
TGTGAGGCCAACAAA	False	ADAMTS3
TGTGATGAATGTGGG	False	ZNF189,ZNF562,ZNF879
TGTGCCACCCCTGTC	False	CD209
TGTGCGGCCCAGGGG	False	PLBD2
TGTGCTGGATAACCT	False	TRIM22
TGTGCTGTGGCCGCC	True	
TGTGGAATACAAGGG	False	SLC25A41
TGTGGAGGCCTTCGA	False	CYP26A1
TGTGGCATTTTTCAT	False	SLC7A14
TGTGGCCTTCGCACA	True	
TGTGGTCAAGCTGTA	False	RP1
TGTGTAAGAGCTATA	False	ENPP2
TGTGTCGGCAAAGCT	False	LAP3
TGTGTGGCCAGTCGT	False	GPR15
TGTGTTGGTCCCCGA	False	PLA2G10
TGTTAGCTGGAAAGC	False	LAP3
TGTTCACCCAAGGCT	False	OR13C9
TGTTCCCATAGACTT	False	NRIP1
TGTTGAATGGGCTGA	False	SYNCRIP
TGTTGCTACAGCAGA	False	KPNA1
TGTTGGGAATGGAGC	False	ADAMTS3
TGTTGTTAGAGCCAA	False	LAP3
TGTTTCTATGCATTT	False	SLC7A3
TTAAATAGCCCTTTG	False	NRIP1
TTAACCCTTACTGTG	False	KPNA1
TTAAGATGTTTGATA	False	ADAMTS3
TTAATATTATAGGTC	False	LAP3
TTAATTTCTTCAATA	False	PLEKHM3
TTACACCATGAGAAT	False	SLC7A14
TTACATCAAGCAAAG	False	NRIP1
TTACCAGGCAGAACA	False	CFAP45
TTACCTACATCTTGC	False	EVI2A
TTACGGCACGTCCAA	False	MYOT
TTACTGAATTGGTCA	False	MYBPC1
TTACTTGAAACAGCA	False	ENPP2
TTAGAGCCAAAAACG	False	LAP3
TTAGCCGGCAGTCAC	False	ZNF875
TTAGTCAGTTTGGGA	False	SYNCRIP
TTATAACATTGAAGA	False	ADAMTS3
TTATATCCATGTTCT	False	OR13C9
TTATCCAGAAAAACA	False	ATF6
TTATGAAGATCCTGA	False	CFAP91
TTATGTATGTTGTAG	False	MTMR8
TTATTCACAGAGAGG	False	SYNCRIP
TTATTGTGGGGAGAG	False	MYBPC1
TTCAAAGAAACCCAA	False	CFAP91
TTCAAGCTCAGGATG	False	MYOT
TTCAATCTTGTGTGC	False	EXOC1L
TTCACAGAGAGGAGG	False	SYNCRIP
TTCACCCCTCTGCAC	False	FEM1A
TTCACTCTGCCCCCA	False	ADISSP
TTCAGACAGAGTTCA	False	ZNF879
TTCAGCAGATGCCAT	False	CFAP91
TTCAGCTTCTTCCCC	False	DNAJC22
TTCAGGTTCCTGGCT	False	SLC7A14
TTCAGTTTATTTGGA	False	GPR15
TTCATGCTGCTCCTG	False	ABCF2-H2BK1,PLA2G10
TTCATTGGAATGAAG	False	ASS1
TTCCAATTTGCTCAG	False	USP36
TTCCAGAGGAAGGAG	False	ZNF879
TTCCAGGTCCGGCAG	False	GLTPD2
TTCCATGTCTTCTTG	False	SNX6
TTCCCCTGGGTGGCC	False	SETDB1
TTCCGAAAGACCAGC	False	ENPP2
TTCCGGTGGGCCCTG	False	ADISSP
TTCCTCATCCTTTAA	False	ZNF562
TTCCTCTTTGCGGTG	False	TRPM8
TTCCTGGATGAACCC	False	ABCF2-H2BK1
TTCCTGTTGTCTCTT	False	ZC3H7A
TTCGAACATTATACA	False	LAP3
TTCGAGGTGCGAGAG	False	SYNCRIP
TTCGCCGAGAACCAG	False	ARL4C
TTCGGCACAGGGCCG	False	USP36
TTCGGGTTGCTCTGA	False	CYP26A1
TTCGTGGCCGAGCTC	False	KLF4
TTCTACCCCCAGAAG	False	SEPTIN3
TTCTCAGTGGAGGAG	False	SLC7A14
TTCTCCTACGCCACA	False	SLC7A14
TTCTCTCTTACTGCC	False	ATP1A2
TTCTGACTACATCTC	False	SLC7A14
TTCTGGAGGATCAGC	False	KPNA1
TTCTGGTGGAATTTT	False	OR13C9
TTCTGTGAGAAGGAC	True	
TTCTGTGTTGCTACA	False	COX7B2
TTCTTCAGGATTGCC	False	NPIPB4,NPIPB5
TTCTTGAGTGCTTTT	False	BLMH
TTGAAAACTCCAACA	False	MTMR8
TTGAAGCCAGCTCCT	False	ENPP2
TTGAATTGGTTCAGC	False	DNAJC22
TTGACCAATCCTCTT	False	MTMR8
TTGACTCGGAGACAA	False	UIMC1
TTGAGCACGAACGAA	False	SNX6
TTGAGGATGTCAGCA	False	ASS1
TTGATAAGAATCAAA	False	MYBPC1
TTGATGAGGATCAGA	False	NGDN
TTGCACACATGAAGA	False	ABCF2-H2BK1
TTGCAGCCGTCGCAT	False	SLC7A14
TTGCATTTGCTCAGA	False	CYP27B1
TTGCCAGTGCCACCA	False	HMOX1
TTGCCGGAGGTAGCA	False	KRT5
TTGCGCACCTGCCAC	False	CFAP91
TTGCTATCTACTTCG	False	SLC7A3
TTGCTGAGCTGGTGT	False	ASS1
TTGCTGTGGTGGGAA	False	SEPTIN3
TTGCTTTGGGCCTCG	False	SLC7A3
TTGGAAGACCTAAAA	False	ARMT1
TTGGACTTCAGTCAG	False	RP1
TTGGAGGTGGTGCCG	False	KRT5
TTGGCAAAAGGCCTG	False	CRHR1
TTGGCATTTATAATA	False	ATF6
TTGGCGGGAGTGGAC	False	CYP27B1
TTGGGAAAAATCTTG	False	ZNF879
TTGGGCACGGAACCC	False	HS3ST2
TTGGGGGTCATGGAC	False	ADAMTS3
TTGGTCAAAAGCTGG	False	SLC7A3
TTGGTGGGCTGTGGC	False	TRPM8
TTGTAATCTTATTCG	False	ZNF189
TTGTCAAAGCCCTGG	False	JUNB
TTGTCCCTATGTCCC	False	EXOC1L
TTGTGAACATCATCC	False	SEPTIN3
TTGTGCCTGCCTTTG	False	SLC7A14
TTGTGGCATTTTTCA	False	SLC7A14
TTGTGTCCTGCTTTC	False	KLHL33
TTGTTCCTTTGGCTG	False	MYBPC1
TTGTTTCTGATACTA	False	ARMT1
TTTAAATTTCCATGT	False	SNX6
TTTAAGTCCTTTGAG	False	RP1
TTTAATGAAGGAAAT	False	ZC3H7A
TTTACAGTCGAGCTG	False	CYP26A1
TTTACCACAGAAAGT	False	SYNCRIP
TTTACTATATTTTCG	False	GPR15,SETDB1
TTTACTGTCAGTCCA	False	ADAMTS3
TTTAGCGCATCTTGG	False	ABCF2-H2BK1
TTTAGGAATCTATTC	False	LAP3
TTTATATGCATTTGT	False	SLC7A3
TTTATCACCCTCAAT	False	IL20RA
TTTATGGAACACATG	False	RP1
TTTATGGTAAAAGGG	False	
TTTATTTTCATTTTC	False	
TTTCAAAAGAACCTT	False	KPNA1
TTTCAAAGGAATATT	False	ACTR10
TTTCAAGATGGATGG	False	
TTTCACAGCTTCTAG	False	
TTTCACCTTACAACT	False	PLEKHM3
TTTCACTGACTTTGA	False	
TTTCAGGATTTGCTG	False	DTNA
TTTCAGTACTCGATG	False	
TTTCAGTATTTGCTG	False	DTNA
TTTCATAGCCTTCAT	False	
TTTCATTTCAAAGGC	False	MTMR8
TTTCCAAGAAACTAA	False	TRIM22
TTTCCACCATCAACC	False	
TTTCCAGCGTGACAT	False	
TTTCCATGCAACATA	False	IL20RA
TTTCCCAGACAACAA	False	CFAP91
TTTCCGAAAAGTTAG	False	
TTTCCTACCGTCGCC	False	TRPM8
TTTCCTCTCTATATT	False	
TTTCCTGGATGGAAC	False	PLEKHM3
TTTCGAAGAATATAG	False	
TTTCGCCTACTCGCA	False	
TTTCGGATCCTCTTA	False	
TTTCGGGATGTCCGG	False	BCL6
TTTCGTTCCGTGGCG	False	SAA1
TTTCTAAGTCCGAAA	False	
TTTCTACTGACTCGT	False	
TTTCTCCAGCCTCCT	False	ATF6
TTTCTCCTGAGACCC	False	UIMC1
TTTCTCGACCTGTTT	False	TRIM22
TTTCTCGGCGAAAAT	False	
TTTCTGCCATCAAGC	False	BCL6
TTTCTGGGCTCTTTT	False	
TTTCTGGGTCCTTAC	False	PTGES
TTTCTGGTGTAATGC	False	
TTTCTTATGACGGGA	False	PLBD2
TTTCTTGTATGAATG	False	BLMH
TTTCTTTCTCATAGA	False	
TTTGAAAGTGGAAGT	False	TRIM43
TTTGAATCATATCCT	False	ENPP2
TTTGACAACAACACC	False	FEM1A
TTTGACAACCTGGTT	False	SLC7A3
TTTGAGCCCAAGAAG	False	MYBPC1
TTTGAGGAATGTAGT	False	NRIP1
TTTGATCCGGAAGGC	False	DTNA
TTTGATGATGTCCAG	False	KPNA1
