oligo	WNT4	off_target
AACCGGCGCTGGAAC	True	
AAGGTGGTGACGAAA	True	
AAGTGCGGCTGTGAC	True	
ACCAGAGAGGCTATG	True	
ACTGGTGCCACGCAT	True	
AGAAACTCAAGGGCC	True	
AGACGTGCGAGAAAC	True	
AGCCACGCCGCGTGC	True	
AGCCTAGCCCCGACT	True	
AGCTGGCTGAACGCT	True	
AGGACCCTACCAAAC	True	
AGGGGCCGAACATGC	True	
CAACGCCATCGACGG	True	
CACAAGGCAAGAGGA	True	
CAGGGCACTGGTGAC	True	
CAGTGACGCGGGCGT	True	
CATTGAGGAGTGCCA	True	
CCAAGGCCATCTACG	True	
CCGCGGTGCCCAGCT	True	
CGGCAGGTGTGGCCT	True	
CGGGAGGCGGCCTTC	True	
CGTGCCGCCCTTCCG	True	
CGTGCTGGCGAGCCG	True	
CTGGTGCTGCTTCGT	True	WNT5A
GAACCTCCACAACAA	True	WNT5A
GAACTCTTCTCCAAC	False	
GAATGTGGAAAGGCC	False	ZNF189
GACAACATCGCCTAC	True	
GACAGGACTGTGCAT	True	
GACATGCGAAGCGGC	True	
GAGGAGCAGCGGCTA	False	
GAGTCGGCACTGGTT	False	
GATCAAGAGGCTGAG	False	
GATCCAGAGGCTGAG	False	
GATGGCACATTTGAC	False	
GCAAGAGGAACAAGA	True	
GCAGCGCAAGAAGGT	False	
GCCACGCAACGCACA	True	
GCCGGTGGAATGCAA	True	
GCGAGAAACTCAAGG	True	
GCGCAGGTGGAGCGG	True	
GCGTGCTGGGCACGA	True	
GCTGAACGCTGCAGT	True	
GCTGCAGGTGCAGGG	False	
GCTGTACCGGGGCAT	False	
GGAAGAAGAGGAAGA	False	
GGAAGATCTGGAGGC	False	
GGAGAGAAGCCCTAC	False	ZNF875
GGAGCCACGCCGCGT	True	
GGAGGCCAAATCAAC	False	
GGAGGCGGCCTTCGT	True	
GGCAATGGGATCATT	False	
GGCCATCGACGGCGG	True	
GGGCAGCTGAAGCTT	False	
GGGCCCTCGTCCAGC	True	
GGGGAGAAACCTTAT	False	ZNF189,ZNF875
GGGGAGGAAGCCAAG	False	
GGGTGGAATGCAAGT	True	
GGTGGAGCGGGCTGA	True	
GGTGTCAGGCTCCTG	True	
GTACTTGGAGCCTAG	True	
GTCAGCCCACAGGGC	True	
GTGCGGGAGAGAAGC	True	
TAAGGAATGTAGGAA	False	ZNF562
TCACTGCCCTTCCAC	False	
TCCACAACAATGAGG	True	
TCCACTGGTCAGGAT	True	
TCCCTTTCCACCCTC	False	
TCCGCTTCTCCGATG	False	
TGAACTGACCAGGCA	False	
TGAATGTGGGAAGAC	False	ZNF189,ZNF562
TGCAAGTGCCACGGG	True	WNT5A
TGCATGGGCTCAGCC	True	
TGCGGCTGTGACAGG	True	
TGCGGGAGAGAACCA	True	
TGCTGCTCCAGCTGC	False	
TGCTTCGTCAAGTGC	True	WNT5A
TGGACACATCCTGGC	False	
TGGTGCTGCTGCCCC	False	
TGTGAAGAATGTGGA	False	ZNF189,ZNF562
TGTGATGAATGTGGG	False	ZNF189,ZNF562
TGTGCTGTGGCCGCC	True	
TGTGGCCTTCGCACA	True	
TTCATGCTGCTCCTG	False	
TTCTGTGAGAAGGAC	True	
TTTCTACTGACTCGT	False	
TTTCTCGGCGAAAAT	False	
TTTCTGGGCTCTTTT	False	
TTTCTGGTGTAATGC	False	
TTTCTTATGACGGGA	False	
TTTCTTGTATGAATG	False	
TTTCTTTCTCATAGA	False	
TTTGAAAGTGGAAGT	False	
TTTGAATCATATCCT	False	
TTTGACAACAACACC	False	
TTTGACAACCTGGTT	False	
TTTGAGCCCAAGAAG	False	MYBPC1
TTTGAGGAATGTAGT	False	NRIP1
TTTGATCCGGAAGGC	False	
TTTGATGATGTCCAG	False	
