oligo	WNT4	off_target
AACCGGCGCTGGAAC	True	
AAGGTGGTGACGAAA	True	
AAGTGCGGCTGTGAC	True	
ACCAGAGAGGCTATG	True	
ACTGGTGCCACGCAT	True	
AGAAACTCAAGGGCC	True	
AGACGTGCGAGAAAC	True	
AGCCACGCCGCGTGC	True	
AGCCTAGCCCCGACT	True	
AGCTGGCTGAACGCT	True	
AGGACCCTACCAAAC	True	
AGGGGCCGAACATGC	True	
CAACGCCATCGACGG	True	
CACAAGGCAAGAGGA	True	
CAGGGCACTGGTGAC	True	
CAGTGACGCGGGCGT	True	
CATTGAGGAGTGCCA	True	
CCAAGGCCATCTACG	True	
CCGCGGTGCCCAGCT	True	
CGGCAGGTGTGGCCT	True	
CGGGAGGCGGCCTTC	True	
CGTGCCGCCCTTCCG	True	
CGTGCTGGCGAGCCG	True	
CTGGTGCTGCTTCGT	True	WNT5A
GAACCTCCACAACAA	True	BCAP31,WNT5A
GAACTCTTCTCCAAC	False	FEM1A,TRPM8
GAATGTGGAAAGGCC	False	ZNF189,ZNF879
GACAACATCGCCTAC	True	
GACAGGACTGTGCAT	True	
GACATGCGAAGCGGC	True	
GAGGAGCAGCGGCTA	False	DPP9,MRPL12
GAGTCGGCACTGGTT	False	RP1,SLC7A3
GATCAAGAGGCTGAG	False	KRT5,TRIM22
GATCCAGAGGCTGAG	False	KRT5,TRIM22
GATGGCACATTTGAC	False	RP1,ZNF879
GCAAGAGGAACAAGA	True	
GCAGCGCAAGAAGGT	False	ABCF2-H2BK1,CYP26A1
GCCACGCAACGCACA	True	
GCCGGTGGAATGCAA	True	
GCGAGAAACTCAAGG	True	
GCGCAGGTGGAGCGG	True	
GCGTGCTGGGCACGA	True	
GCTGAACGCTGCAGT	True	CD209
GCTGCAGGTGCAGGG	False	CYP27B1,KRT5
GCTGTACCGGGGCAT	False	CYP26A1,SLC25A41
GGAAGAAGAGGAAGA	False	CDCA8,KLHL33
GGAAGATCTGGAGGC	False	FEM1A,PGAM2
GGAGAGAAGCCCTAC	False	BCL6,ZNF875,ZNF879
GGAGCCACGCCGCGT	True	
GGAGGCCAAATCAAC	False	SEPTIN3,SETDB1
GGAGGCGGCCTTCGT	True	
GGCAATGGGATCATT	False	LAP3,USP36
GGCCATCGACGGCGG	True	
GGGCAGCTGAAGCTT	False	RP1,TRPM8
GGGCCCTCGTCCAGC	True	
GGGGAGAAACCTTAT	False	ZNF189,ZNF875,ZNF879
GGGGAGGAAGCCAAG	False	ADAMTS3,SLC7A14
GGGTGGAATGCAAGT	True	
GGTGGAGCGGGCTGA	True	
GGTGTCAGGCTCCTG	True	
GTACTTGGAGCCTAG	True	
GTCAGCCCACAGGGC	True	
GTGCGGGAGAGAAGC	True	
TAAGGAATGTAGGAA	False	ZNF562,ZNF879
TCACTGCCCTTCCAC	False	NPIPB4,NPIPB5
TCCACAACAATGAGG	True	
TCCACTGGTCAGGAT	True	
TCCCTTTCCACCCTC	False	NPIPB4,NPIPB5
TCCGCTTCTCCGATG	False	BCL6,HMOX1
TGAACTGACCAGGCA	False	KLF4,PPP1R13L
TGAATGTGGGAAGAC	False	ZNF189,ZNF562
TGCAAGTGCCACGGG	True	WNT5A
TGCATGGGCTCAGCC	True	
TGCGGCTGTGACAGG	True	
TGCGGGAGAGAACCA	True	
TGCTGCTCCAGCTGC	False	SCYGR6,SLC7A3
TGCTTCGTCAAGTGC	True	WNT5A
TGGACACATCCTGGC	False	ABCF2-H2BK1,NSDHL
TGGTGCTGCTGCCCC	False	CRHR1,CYSRT1
TGTGAAGAATGTGGA	False	ZNF189,ZNF562
TGTGATGAATGTGGG	False	ZNF189,ZNF562,ZNF879
TGTGCTGTGGCCGCC	True	
TGTGGCCTTCGCACA	True	
TTCATGCTGCTCCTG	False	ABCF2-H2BK1,PLA2G10
TTCTGTGAGAAGGAC	True	
TTTCTACTGACTCGT	False	
TTTCTCGGCGAAAAT	False	
TTTCTGGGCTCTTTT	False	
TTTCTGGTGTAATGC	False	
TTTCTTATGACGGGA	False	PLBD2
TTTCTTGTATGAATG	False	BLMH
TTTCTTTCTCATAGA	False	
TTTGAAAGTGGAAGT	False	TRIM43
TTTGAATCATATCCT	False	ENPP2
TTTGACAACAACACC	False	FEM1A
TTTGACAACCTGGTT	False	SLC7A3
TTTGAGCCCAAGAAG	False	MYBPC1
TTTGAGGAATGTAGT	False	NRIP1
TTTGATCCGGAAGGC	False	DTNA
TTTGATGATGTCCAG	False	KPNA1
