oligo	WNT4	off_target
AAAACACGGAAGGTA	False	
AACCGGCGCTGGAAC	True	
AACTCTGCCAAGGCC	False	
AAGGAACCCATGAAT	False	ZNF189
AAGGAGCTGCAGCAG	False	
AAGGTGGTGACGAAA	True	
AAGTGCGGCTGTGAC	True	
AATTCACACTGGTGA	False	ZNF189
ACATCGTGGAGAACC	False	
ACCAGAGAGGCTATG	True	
ACTGGTGCCACGCAT	True	
AGAAACTCAAGGGCC	True	
AGAAGTAGAAGAAAA	False	
AGACGTGCGAGAAAC	True	
AGAGAATTCATACTG	False	ZNF189
AGAGCCTCAAGGACA	False	
AGCAGCTCAGGAGGC	False	
AGCCACGCCGCGTGC	True	
AGCCTAGCCCCGACT	True	
AGCTGGCTGAACGCT	True	
AGCTGGTGCCTGAGC	False	
AGGACCCTACCAAAC	True	
AGGGGCCGAACATGC	True	
AGTGGAAGAGGAAGA	False	
ATAAATGTAGTGACT	False	ZNF189
ATATATGAAGTGAAT	False	
ATATGCACTGCAGTG	False	
ATCCACACTGGTGAA	False	ZNF189
ATGCCACCCTCCAGT	False	
ATTCACACTGGTGAG	False	ZNF189
ATTGTCCAGGCCTTC	False	
CAACGCCATCGACGG	True	
CACAAGGCAAGAGGA	True	
CACCTCCCTGTCAGC	False	
CAGCCCCCAGCCCCG	False	
CAGGAACAGAGAATG	False	ZNF189
CAGGAGGGACCCCGG	False	
CAGGGAAGGATGCCT	False	
CAGGGCACTGGTGAC	True	
CAGTGACGCGGGCGT	True	
CATGAAAAAACTCAT	False	ZNF562
CATTCAACATCAAAG	False	ZNF189
CATTGAGGAGTGCCA	True	
CCAAAAGGAATGTCA	False	NRIP1
CCAACCACACCATCA	False	
CCAACCTGAAAACCC	False	
CCAAGGCCATCTACG	True	
CCACGCAGGTGACAG	False	
CCAGTGTCTCTCCTA	False	
CCCTACAAATGTAAG	False	ZNF562
CCCTGGGCTCGGGCG	False	
CCGAGGAGCTGGCTA	False	
CCGCGGTGCCCAGCT	True	
CCTGAAGATCCTGCA	False	
CCTGATGGTGCTAAC	False	
CCTTTGCCATGCTGG	False	
CGCTTCCACCCTGAG	False	
CGGCAGGTGTGGCCT	True	
CGGGAGGCGGCCTTC	True	
CGTGCCGCCCTTCCG	True	
CGTGCTGGCGAGCCG	True	
CTCCGCTTCTCCGAT	False	
CTCTACGAGCGCCTG	False	
CTGCTGTGGACTGCA	False	
CTGGAGAAAAACCCT	False	ZNF189,ZNF562
CTGGTGCTGCTTCGT	True	WNT5A
CTTCCACACTCAGCT	False	
CTTCTGCTCCTTCAT	False	
GAACCTCCACAACAA	True	WNT5A
GAACTCTTCTCCAAC	False	
GAATGTGGAAAGGCC	False	ZNF189
GACAACATCGCCTAC	True	
GACAGGACTGTGCAT	True	
GACATGCGAAGCGGC	True	
GAGGAGCAGCGGCTA	False	
GAGTCGGCACTGGTT	False	
GATCAAGAGGCTGAG	False	
GATCCAGAGGCTGAG	False	
GATGGCACATTTGAC	False	
GCAAGAGGAACAAGA	True	
GCAGCGCAAGAAGGT	False	
GCCACGCAACGCACA	True	
GCCGGTGGAATGCAA	True	
GCGAGAAACTCAAGG	True	
GCGCAGGTGGAGCGG	True	
GCGTGCTGGGCACGA	True	
GCTGAACGCTGCAGT	True	
GCTGCAGGTGCAGGG	False	
GCTGTACCGGGGCAT	False	
GGAAGAAGAGGAAGA	False	
GGAAGATCTGGAGGC	False	
GGAGAGAAGCCCTAC	False	ZNF875
GGAGCCACGCCGCGT	True	
GGAGGCCAAATCAAC	False	
GGAGGCGGCCTTCGT	True	
GGCAATGGGATCATT	False	
GGCCATCGACGGCGG	True	
GGGCAGCTGAAGCTT	False	
GGGCCCTCGTCCAGC	True	
GGGGAGAAACCTTAT	False	ZNF189,ZNF875
GGGGAGGAAGCCAAG	False	
GGGTGGAATGCAAGT	True	
GGTGGAGCGGGCTGA	True	
GGTGTCAGGCTCCTG	True	
GTACTTGGAGCCTAG	True	
GTCAGCCCACAGGGC	True	
GTGCGGGAGAGAAGC	True	
TAAGGAATGTAGGAA	False	ZNF562
TCACTGCCCTTCCAC	False	
TCCACAACAATGAGG	True	
TCCACTGGTCAGGAT	True	
TCCCTTTCCACCCTC	False	
TCCGCTTCTCCGATG	False	
TCTTCATCATCCTCC	False	
TCTTCCTATGGGAAA	False	ZNF189
TCTTCGGGGAAATAT	False	
TCTTCTGAGGACTGG	False	NRIP1
TCTTGACCCTGGCTA	False	
TCTTGCTTGCTCCAA	False	
TCTTGTCACATTGCC	False	
TCTTTCACACGTCGT	False	
TCTTTGCCACATCTG	False	
TCTTTTCATGGTCAG	False	
TGAAAAATATGAAGT	False	
TGAAAATAAAATCTG	False	NRIP1
TGAAACCTATCTCAT	False	
TGAAAGGAAAAGTTT	False	
TGAACAGGAGCTTTA	False	
TGAACCTTTGCACCC	False	
TGAACTGACCAGGCA	False	
TGAAGAACCCAAAGG	False	
TGAAGACGCTCAAGG	False	
TGAAGATAGCTGCCA	False	PLEKHM3
TGAAGCCACCACTGA	False	
TGAAGCTTGGGGCCA	False	
TGAAGTAGATTATAA	False	
TGAATACCCTGATGG	False	
TGAATGATATTCTGA	False	
TGAATGTGGGAAGAC	False	ZNF189,ZNF562
TGACAAAAGATTCTT	False	
TGACAGGGGGAACTG	False	
TGACATGGGAGGAGC	False	
TGACCAGCTCAAGAA	False	
TGACCCAGGAACAGA	False	ZNF189
TGACCGCACACTGGA	False	
TGACCTGCTACTGTT	False	
TGACTATCCATTAGA	False	
TGACTGCGCCGAGTC	False	
TGACTTCCTGTCCAA	False	
TGAGAAATGGAACTA	False	
TGAGAATCCGGCTGG	False	
TGAGAGAGTCAAAGA	False	
TGAGATCTCTGAGAT	False	
TGAGCCAACTGATGC	False	
TGAGCGCACTATTCA	False	
TGAGCTCTTGACCCT	False	
TGAGGAACTGGGTAT	False	
TGAGGAGGAATGTAG	False	
TGAGGCCACTGGCAT	False	
TGAGGGATTCTGCAT	False	
TGAGGTGGAGCTACA	False	
TGAGTCATCTCTCTC	False	ZNF875
TGAGTGTAACAAACG	False	
TGATAAAAAATCGAG	False	
TGATACTACTATACA	False	
TGATATTCTGAATCA	False	
TGATCCCAAGGTTTT	False	
TGATCTATGTGGAGG	False	
TGATGAGGGCCCTGA	False	
TGATGCCTACAATGT	False	MYBPC1
TGATGGACTTGGCCC	False	
TGATGGGGCTCACAA	False	
TGATGTGATCGCTAG	False	
TGATTCAATAGGTGC	False	
TGATTGGGAACCACA	False	
TGCAAAAGCAAGGCA	False	
TGCAAATGATGGTGG	False	
TGCAAGAAGAAGGTT	False	
TGCAAGTGCCACGGG	True	WNT5A
TGCACAAGGAAGCCT	False	ZNF562
TGCACCCCAGAGGGA	False	
TGCACGTGCCCCATG	False	
TGCAGAAAGCCTGCC	False	
TGCAGAGAAAAAGGC	False	
TGCAGCACCTACCCT	False	
TGCAGCCGCAAGTCC	False	
TGCAGGGAATGTGGG	False	ZNF875
TGCAGTCATCCATGT	False	NRIP1
TGCATACATATGAGA	False	
TGCATCTCAGTTGCC	False	
TGCATGGGCTCAGCC	True	
TGCATTGGGTGGGAG	False	
TGCCAACCGCAGCCG	False	
TGCCACCAAGGTTTA	False	
TGCCACTTCTGGGAC	False	
TGCCAGCTCCTGATG	False	
TGCCATCCGGAAGAG	False	
TGCCCAAGGAGGTGG	False	
TGCCCATCCCTGAGC	False	
TGCCCCCGTTCCAGT	False	
TGCCCGGTTACATGG	False	PLEKHM3
TGCCCTGCTTCGAGA	False	
TGCCGCGGCTGCTGT	False	
TGCCTCATAGATACC	False	
TGCCTGAGAAATACT	False	
TGCCTGGTGAAGAAC	False	
TGCCTTTCTGCAGGA	False	
TGCGAGAGCCTCAAG	False	
TGCGCACTTGGCGCC	False	
TGCGCTACACGCAGA	False	
TGCGGATCTGGGCCG	False	
TGCGGCTGTGACAGG	True	
TGCGGGAGAGAACCA	True	
TGCGGTTCCTGGAGC	False	
TGCGTTCTCTGAACA	False	
TGCTACATCATTGAT	False	
TGCTCAGAGCTGACT	False	
TGCTCCAGAGGAAAT	False	
TGCTCTGCAGCACGC	False	
TGCTGACAAGCTGTA	False	
TGCTGATCGATGTGT	False	
TGCTGCCACTGCCCC	False	
TGCTGCTCCAGCTGC	False	
TGCTGGACATCTGTC	False	
TGCTGGCCAGGGGTA	False	
TGCTGGTCATGGCTC	False	NRIP1
TGCTGTGCCCGGTTA	False	PLEKHM3
TGCTTACCATCCTGG	False	
TGCTTCGTCAAGTGC	True	WNT5A
TGCTTGTCCCTATGT	False	
TGCTTTGTGGGGCTC	False	
TGGAAAAGAACCAGG	False	
TGGAAAGAGGAAGAC	False	
TGGAAATTCTCGTGT	False	
TGGAACCATCATTAC	False	
TGGAAGCTGAATATT	False	
TGGAAGTTCGCGCCT	False	
TGGAATTAATTCTGC	False	
TGGACACATCCTGGC	False	
TGGACCGGCGGGGAG	False	
TGGACGCGGAGCAGC	False	
TGGACTCTGCCTCAT	False	
TGGAGAAAGTGGAGT	False	
TGGAGACAGATGTGC	False	
TGGAGAGGGCCATCA	False	
TGGAGCAGCTTAGCC	False	
TGGAGCTCTACGAGC	False	
TGGAGGACTGCAATA	False	
TGGAGGCCAGGATGG	False	PLEKHM3
TGGAGTATCATAACC	False	
TGGAGTTTACCAAGA	False	
TGGATGAACTGAAAA	False	
TGGATGCTGACCCTG	False	
TGGATGTTTTGAACA	False	ZNF189
TGGCAAAGAGCACGT	False	
TGGCACACAGCCACA	False	
TGGCAGAAACCTTTG	False	
TGGCAGTGGCTATGG	False	
TGGCCAAAGGATCTG	False	
TGGCCCGGCTGCTGC	False	
TGGCCGCCCCATAGC	False	
TGGCCTCATCACTGT	False	
TGGCCTTAATTTTCA	False	
TGGCGCCGGGCGGCA	False	
TGGCGGTGGCCTCGG	False	
TGGCTATGCAACAAC	False	
TGGCTCGAGAAGCAG	False	
TGGCTGCAATCCACC	False	
TGGCTGGGAGTGTAC	False	
TGGCTGTTGGCTCCC	False	
TGGCTTTGGCCATAT	False	WNT5A
TGGGAAATGTGACAG	False	
TGGGAATGCCATATG	False	
TGGGAGACAATGAGA	False	
TGGGAGGGGCTATTT	False	
TGGGATTATAACATT	False	
TGGGCCATCACAAAT	False	
TGGGCCTGTGTCCAC	False	
TGGGCTCACTCTGCT	False	
TGGGCTGGGCTGGCT	False	
TGGGGACATGGGCAT	False	
TGGGGCTCGGGGCGG	False	
TGGGGGGCTACGTAG	False	
TGGGGTTCAGAAACT	False	
TGGGTGGTATACTGT	False	
TGGTAAAGGAGGACT	False	
TGGTAGGACTTGCAC	False	
TGGTCAGACTCTCCC	False	
TGGTCGCTAGGTATG	False	WNT5A
TGGTCTTGATGCTGA	False	MYBPC1
TGGTGCAGTGGGCTG	False	
TGGTGCTGCTGCCCC	False	
TGGTGGCACTGGATG	False	
TGGTGGGCTGTGGCT	False	
TGGTTACCAAAGTGT	False	
TGGTTGAGCTGCAAT	False	
TGGTTTGGATGCAGC	False	
TGTAACAACTCCTGG	False	
TGTACCCAGCTCTGA	False	
TGTACGGTCAAGTGT	False	WNT8A
TGTAGCAAAGTGCTC	False	
TGTATACGACTGCGG	False	
TGTATGGGGTACTCA	False	
TGTCAACGTCATCTT	False	
TGTCACCTGCTCCCC	False	
TGTCAGCAGCCTCCT	False	
TGTCATCCCTCACGA	False	
TGTCCACACCGCCAG	False	
TGTCCCCAACAGCAA	False	
TGTCCTTCTCACTTC	False	
TGTCTCCTTCTTCGC	False	
TGTCTGCCTGGAGTG	False	ZNF875
TGTCTTCCAACCCTG	False	
TGTGAAGAATGTGGA	False	ZNF189,ZNF562
TGTGACTACCAGCTT	False	PLEKHM3
TGTGAGGCCAACAAA	False	
TGTGATGAATGTGGG	False	ZNF189,ZNF562
TGTGCCACCCCTGTC	False	
TGTGCGGCCCAGGGG	False	
TGTGCTGGATAACCT	False	
TGTGCTGTGGCCGCC	True	
TGTGGAATACAAGGG	False	
TGTGGAGGCCTTCGA	False	
TGTGGCATTTTTCAT	False	
TGTGGCCTTCGCACA	True	
TGTGGTCAAGCTGTA	False	
TGTGTAAGAGCTATA	False	
TGTGTCGGCAAAGCT	False	
TGTGTGGCCAGTCGT	False	
TGTGTTGGTCCCCGA	False	
TGTTAGCTGGAAAGC	False	
TGTTCACCCAAGGCT	False	
TGTTCCCATAGACTT	False	NRIP1
TGTTGAATGGGCTGA	False	
TGTTGCTACAGCAGA	False	
TGTTGGGAATGGAGC	False	
TGTTGTTAGAGCCAA	False	
TGTTTCTATGCATTT	False	
TTAAATAGCCCTTTG	False	NRIP1
TTAACCCTTACTGTG	False	
TTAAGATGTTTGATA	False	
TTAATATTATAGGTC	False	
TTAATTTCTTCAATA	False	PLEKHM3
TTACACCATGAGAAT	False	
TTACATCAAGCAAAG	False	NRIP1
TTACCAGGCAGAACA	False	
TTACCTACATCTTGC	False	
TTACGGCACGTCCAA	False	
TTACTGAATTGGTCA	False	MYBPC1
TTACTTGAAACAGCA	False	
TTAGAGCCAAAAACG	False	
TTAGCCGGCAGTCAC	False	ZNF875
TTAGTCAGTTTGGGA	False	
TTATAACATTGAAGA	False	
TTATATCCATGTTCT	False	
TTATCCAGAAAAACA	False	
TTATGAAGATCCTGA	False	
TTATGTATGTTGTAG	False	
TTATTCACAGAGAGG	False	
TTATTGTGGGGAGAG	False	MYBPC1
TTCAAAGAAACCCAA	False	
TTCAAGCTCAGGATG	False	
TTCAATCTTGTGTGC	False	
TTCACAGAGAGGAGG	False	
TTCACCCCTCTGCAC	False	
TTCACTCTGCCCCCA	False	
TTCAGACAGAGTTCA	False	
TTCAGCAGATGCCAT	False	
TTCAGCTTCTTCCCC	False	
TTCAGGTTCCTGGCT	False	
TTCAGTTTATTTGGA	False	
TTCATGCTGCTCCTG	False	
TTCATTGGAATGAAG	False	
TTCCAATTTGCTCAG	False	
TTCCAGAGGAAGGAG	False	
TTCCAGGTCCGGCAG	False	
TTCCATGTCTTCTTG	False	
TTCCCCTGGGTGGCC	False	
TTCCGAAAGACCAGC	False	
TTCCGGTGGGCCCTG	False	
TTCCTCATCCTTTAA	False	ZNF562
TTCCTCTTTGCGGTG	False	
TTCCTGGATGAACCC	False	
TTCCTGTTGTCTCTT	False	
TTCGAACATTATACA	False	
TTCGAGGTGCGAGAG	False	
TTCGCCGAGAACCAG	False	
TTCGGCACAGGGCCG	False	
TTCGGGTTGCTCTGA	False	
TTCGTGGCCGAGCTC	False	
TTCTACCCCCAGAAG	False	
TTCTCAGTGGAGGAG	False	
TTCTCCTACGCCACA	False	
TTCTCTCTTACTGCC	False	
TTCTGACTACATCTC	False	
TTCTGGAGGATCAGC	False	
TTCTGGTGGAATTTT	False	
TTCTGTGAGAAGGAC	True	
TTCTGTGTTGCTACA	False	
TTCTTCAGGATTGCC	False	
TTCTTGAGTGCTTTT	False	
TTGAAAACTCCAACA	False	
TTGAAGCCAGCTCCT	False	
TTGAATTGGTTCAGC	False	
TTGACCAATCCTCTT	False	
TTGACTCGGAGACAA	False	
TTGAGCACGAACGAA	False	
TTGAGGATGTCAGCA	False	
TTGATAAGAATCAAA	False	MYBPC1
TTGATGAGGATCAGA	False	
TTGCACACATGAAGA	False	
TTGCAGCCGTCGCAT	False	
TTGCATTTGCTCAGA	False	
TTGCCAGTGCCACCA	False	
TTGCCGGAGGTAGCA	False	
TTGCGCACCTGCCAC	False	
TTGCTATCTACTTCG	False	
TTGCTGAGCTGGTGT	False	
TTGCTGTGGTGGGAA	False	
TTGCTTTGGGCCTCG	False	
TTGGAAGACCTAAAA	False	
TTGGACTTCAGTCAG	False	
TTGGAGGTGGTGCCG	False	
TTGGCAAAAGGCCTG	False	
TTGGCATTTATAATA	False	
TTGGCGGGAGTGGAC	False	
TTGGGAAAAATCTTG	False	
TTGGGCACGGAACCC	False	
TTGGGGGTCATGGAC	False	
TTGGTCAAAAGCTGG	False	
TTGGTGGGCTGTGGC	False	
TTGTAATCTTATTCG	False	ZNF189
TTGTCAAAGCCCTGG	False	
TTGTCCCTATGTCCC	False	
TTGTGAACATCATCC	False	
TTGTGCCTGCCTTTG	False	
TTGTGGCATTTTTCA	False	
TTGTGTCCTGCTTTC	False	
TTGTTCCTTTGGCTG	False	MYBPC1
TTGTTTCTGATACTA	False	
TTTAAATTTCCATGT	False	
TTTAAGTCCTTTGAG	False	
TTTAATGAAGGAAAT	False	
TTTACAGTCGAGCTG	False	
TTTACCACAGAAAGT	False	
TTTACTATATTTTCG	False	
TTTACTGTCAGTCCA	False	
TTTAGCGCATCTTGG	False	
TTTAGGAATCTATTC	False	
TTTATATGCATTTGT	False	
TTTATCACCCTCAAT	False	
TTTATGGAACACATG	False	
TTTATGGTAAAAGGG	False	
TTTATTTTCATTTTC	False	
TTTCAAAAGAACCTT	False	
TTTCAAAGGAATATT	False	
TTTCAAGATGGATGG	False	
TTTCACAGCTTCTAG	False	
TTTCACCTTACAACT	False	PLEKHM3
TTTCACTGACTTTGA	False	
TTTCAGGATTTGCTG	False	
TTTCAGTACTCGATG	False	
TTTCAGTATTTGCTG	False	
TTTCATAGCCTTCAT	False	
TTTCATTTCAAAGGC	False	
TTTCCAAGAAACTAA	False	
TTTCCACCATCAACC	False	
TTTCCAGCGTGACAT	False	
TTTCCATGCAACATA	False	
TTTCCCAGACAACAA	False	
TTTCCGAAAAGTTAG	False	
TTTCCTACCGTCGCC	False	
TTTCCTCTCTATATT	False	
TTTCCTGGATGGAAC	False	PLEKHM3
TTTCGAAGAATATAG	False	
TTTCGCCTACTCGCA	False	
TTTCGGATCCTCTTA	False	
TTTCGGGATGTCCGG	False	
TTTCGTTCCGTGGCG	False	
TTTCTAAGTCCGAAA	False	
TTTCTACTGACTCGT	False	
TTTCTCCAGCCTCCT	False	
TTTCTCCTGAGACCC	False	
TTTCTCGACCTGTTT	False	
TTTCTCGGCGAAAAT	False	
TTTCTGCCATCAAGC	False	
TTTCTGGGCTCTTTT	False	
TTTCTGGGTCCTTAC	False	
TTTCTGGTGTAATGC	False	
TTTCTTATGACGGGA	False	
TTTCTTGTATGAATG	False	
TTTCTTTCTCATAGA	False	
TTTGAAAGTGGAAGT	False	
TTTGAATCATATCCT	False	
TTTGACAACAACACC	False	
TTTGACAACCTGGTT	False	
TTTGAGCCCAAGAAG	False	MYBPC1
TTTGAGGAATGTAGT	False	NRIP1
TTTGATCCGGAAGGC	False	
TTTGATGATGTCCAG	False	
